#############################
#            .............. #
## ######### ################
#        ............       #
#  ##### .#########         #
#      # .#                 #
#      # .#############     #
# ...... .         ........ #
#############################